1 1 1 1 1 1
1 18 1 1 1 1
1 15 1 17 1 1
1 15 1 18 1 1
1 17 1 17 1 1
1 1 1 1 1 1