1 1 1 1 1 1
1 1 3 11 0 1
1 1 1 1 1 1
1 1 1 0 1 1
1 1 3 1 1 1
1 1 1 11 1 1