1 1 1 1 1 1
1 1 3 3 3 1
1 1 16 12 13 1
1 1 15 0 1 1
1 1 3 1 14 1
1 1 1 11 1 1